111111111
1P0000001
100C001C1
100001001
1C00E0001
111111111
