1111111111111111111111111111111
1P00000000000000000111111111111
1000001111100000000010000000001
100000100010000000001000000C001
1000001000100000000010000000001
1000001000111111111110000000001
1000001000000000000000000000001
1000001111111111111110000000001
1000000000000000000010000000001
1000000000000000000010000000001
1000001111111111111110000000001
1000000000000000000000000000001
100000000000000000000000000C001
100000000000000000000000000E001
1111111111111111111111111111111

